11
7
11111111111
12010010031
10010010031
10000000031
10000010031
10000010031
11111111111