6
5
111111
121001
101001
100001
111111