24
14
111111111111111111111111
100000500001100050500001
100000000001100000000021
100000000001100000000001
100411110001100411111111
100011114001100011111111
100011110001100000000111
104011110001100005000111
100011110001111111000111
100011114001111111004111
100500110000500000000111
100000110000000000000111
100003110000000005000111
111111111111111111111111