11
7
11111111111
12016010031
10010010001
10010000011
10010510001
10000010001
11111111111