16
14
1111111111111111
1110000000400111
1164000500004611
1001100110011001
1051150110511501
1001100400011001
1001113303111001
1001113233111001
1001100400511001
1001150110011001
1501100110011051
1160000000000611
1110000050400111
1111111111111111
